[
 {
    "type": "mapgen",
    "method": "json",
    "om_terrain": [ "generalstore" ],
    "faction_owner": [
		{ "id": "kingdom", "x": [ 1, 24 ], "y": [ 1, 24 ] }				
      ],
    "weight": 100,
    "object": {
      "fill_ter": "t_floor",
      "rows": [
        "                        ",
        "                        ",
        "                        ",
        "                        ",
        "                        ",
        "                        ",
        "   wwwwwwowwwowwwwwww   ",
        "   wxxrOOrccccccXXXXw   ",
        "   oxcrrrrcccc╦cc!cXw   ",
        "   wcYcYcYcYcc╦╦╦╦╦╦o   ",
        "   wcYcYcYcYccccccccw   ",
        "   wcYcYcYcYcYcYcYcYw   ",
        "   ocYcYcYcYcYcYcYcco   ",
        "   wcYcYcYcYcYcYcYcYw   ",
        "   wccccccccccccccccw   ",
        "   wwwwowwwddwwwowwww   ",
        "           ff           ",
        "           ff           ",
        "           ff           ",
        "           ff           ",
        "           ff           ",
        "           ff           ",
        "           ff           ",
        "           ff           "
      ],
      "palettes": [ "city_building_store" ]
    },
    "npcs": {
    "!": { "class": "shopkeeper_general" }
  },
 "items": {
      "x": { "item": "stash_wood", "chance": 100, "repeat": [ 2, 5 ] },
      "Y": [ { "item": "dry_goods", "chance": 100, "repeat": [ 2, 5 ] }, { "item": "mtc_pantry_liquids", "chance": 70, "repeat": [ 2, 5 ] } ],
      "X": [ { "item": "male_citizen_clothing", "chance": 100, "repeat": [ 2, 5 ] }, { "item": "female_citizen_clothing", "chance": 100, "repeat": [ 2, 5 ] }, { "item": "kitchenstaff_wield", "chance": 100, "repeat": [ 2, 5 ] } ]
	  
    }
 },
 {
    "type": "mapgen",
    "method": "json",
    "om_terrain": [ "infirmary" ],
    "faction_owner": [
		{ "id": "kingdom", "x": [ 1, 24 ], "y": [ 1, 24 ] }				
      ],
    "weight": 100,
    "object": {
      "fill_ter": "t_floor",
      "rows": [
        "                        ",
        "                        ",
        " wwowwwowwwwowwwowwwwoww",
        " wuuuu!ccrOOrxccc_cuuuuw",
        " wuccccc!rrrr!ccc!cccc!w",
        " oc!cccccccccccccccccccw",
        " wcwwwwwwowwwowwwwwwwwcw",
        " wcwbbwbbwbbwbbwbbwbbwcw",
        " ocwccwccwccwccwccwccwcw",
        " wcwdwwdwwdwwdwwdwwwdwcw",
        " wcccccccccccccccccccccw",
        " wwwwdwwdwcccwwdwwdwwdww",
        "   occwccwc!cwccwccwccw ",
        "   wcbwcbwcccwcbwcbwcbw ",
        "   wcbwcbwcccwcbwcbwcbw ",
        "   wwwwowwwddwwwowwwwww ",
        "           ff           ",
        "           fff   www    ",
        "           ffffffduw    ",
        "           fff   www    ",
        "           ff           ",
        "           ff           ",
        "           ff           ",
        "           ff           "
      ],
      "palettes": [ "city_building_home" ]
    },
    "npcs": {
    "b": [ { "class": "generic_male_citizen", "chance": 40 }, { "class": "generic_female_citizen", "chance": 40 } ],
    "!": { "class": "medic", "chance": 70 },
    "_": { "class": "medic_head", "chance": 100 }
  },
 "items": {
      "x": { "item": "stash_wood", "chance": 100, "repeat": [ 2, 5 ] },
      "u": [ { "item": "bucket", "chance": 100 } ],
      "O": [ { "item": "oven", "chance": 100, "repeat": [ 2, 5 ] }, { "item": "bandages", "chance": 100, "repeat": [ 4, 10 ] } ]
      
    }
  },
 {
    "type": "mapgen",
    "method": "json",
    "om_terrain": [ "generalstore_roof" ],
    "faction_owner": [
		{ "id": "kingdom", "x": [ 1, 24 ], "y": [ 1, 24 ] }				
      ],
    "weight": 100,
    "object": {
      "fill_ter": "t_floor",
      "rows": [
        "                        ",
        "                        ",
        "                        ",
        "                        ",
        "                        ",
        "                        ",
        "   uuuuuuuuuuuuuuuuuu   ",
        "   uuuuuuuuuuuuuuuuuu   ",
        "   uuuuuuuuuuuuuuuuuu   ",
        "   uuuuuuuuuuuuuuuuuu   ",
        "   uuuuuuuuuuuuuuuuuu   ",
        "   uuuuuuuuuuuuuuuuuu   ",
        "   uuuuuuuuuuuuuuuuuu   ",
        "   uuuuuuuuuuuuuuuuuu   ",
        "   uuuuuuuuuuuuuuuuuu   ",
        "   uuuuuuuuuuuuuuuuuu   ",
        "                        ",
        "                        ",
        "                        ",
        "                        ",
        "                        ",
        "                        ",
        "                        ",
        "                        "
      ],
      "palettes": [ "city_building_roof_palette" ]
  }
},
{
    "type": "mapgen",
    "method": "json",
    "om_terrain": [ "infirmary_roof" ],
    "faction_owner": [
		{ "id": "kingdom", "x": [ 1, 24 ], "y": [ 1, 24 ] }				
      ],
    "weight": 100,
    "object": {
      "fill_ter": "t_floor",
      "rows": [
        "                        ",
        "                        ",
        " uuuuuuuuuuuuuuuuuuuuuuu",
        " uuuuuuuuuuuuuuuuuuuuuuu",
        " uuuuuuuuuuuuuuuuuuuuuuu",
        " uuuuuuuuuuuuuuuuuuuuuuu",
        " uuuuuuuuuuuuuuuuuuuuuuu",
        " uuuuuuuuuuuuuuuuuuuuuuu",
        " uuuuuuuuuuuuuuuuuuuuuuu",
        " uuuuuuuuuuuuuuuuuuuuuuu",
        " uuuuuuuuuuuuuuuuuuuuuuu",
        " uuuuuuuuuuuuuuuuuuuuuuu",
        "   uuuuuuuuuuuuuuuuuuuu ",
        "   uuuuuuuuuuuuuuuuuuuu ",
        "   uuuuuuuuuuuuuuuuuuuu ",
        "   uuuuuuuuuuuuuuuuuuuu ",
        "                        ",
        "                 uuu    ",
        "                 uuu    ",
        "                 uuu    ",
        "                        ",
        "                        ",
        "                        ",
        "                        "
      ],
      "palettes": [ "city_building_roof_palette" ]
    }
}
]